######################
#.##        # #     .#
#    ###### # ###### #
######     T  #      #
#    # ###### ## #####
# #### #         #   #
#        ### ###   # #
##########    ###### #
#.         ##       .#
######################