#################################################
# .  #.        #             #   #     # #   #  #
#    #### ###### #  # # ##         ####  #  ### #
#    #.#    # .# #  # #  #   #   #          #   #
#   .            #.     #### #   ##  ### #      #
# ##### ######  #### #            #    #  #######
#.      #   .#       .# ###  ######  # #  #   # #
### ##  # ####### ##### #    #    ## # #    # # #
#    #  #      #  #      T# ##       #   #### # #
#.      #   #  #  #     #          #        #   #
# # ###   .# #    ## ## ### ## #  # ########### #
#   #    #    #              #    #             #
#################################################
