#########
#T#    .#
#     ###
# #  ####
# ## ####
# ##  ###
#.#    .#
#########